1,1,1,1,1,1,0,
1,0,0,0,0,1,1,
1,0,10,20,0,0,1,
1,0,1,12,0,2,1,
1,0,0,0,0,0,1,
1,1,1,1,1,1,1,
steps:3
